/--------------------------------------------------------------------------------\
|                                                                                |
|                                                                                |
|       #         #     #                                                        |
|          #                                                    #                |
|    # #          #     #   #                               #                    |
|                                                        #      #    #           |
|           #        #                                      #     #              |
|               #                                                      #         |
|        #  #                                                #   #               |
|                #                                        #           #          |
|         #                                                     #                |
|                                                          #        #            |
|                                                               #                |
|                                                                                |
|                                                                                |
|                                                                                |
|                                                                                |
|                                                                                |
|                                                                                |
|                                                                                |
|                                                                                |
|        *                                                          *            |
\--------------------------------------------------------------------------------/
