/--------------------------------------------------------------------------------\
|                                                                                |
|                                                                                |
|                                                                                |
|                                                                                |
|                                                                                |
|                                                                                |
|                                                                                |
|                                                                                |
|                                                                                |
|                                                                                |
|                                                                                |
|                                                                                |
|                                                                                |
|                                                                                |
|                                                                                |
|     *                                                                   *      |
|     ##                                                                  ##     |
|    #--#                                                                #--#    |
|   #----#                                                              #----#   |
|  #------#                                                            #------#  |
| #--------#                                                          #--------# |
|#----------#                                                        #----------#|
\--------------------------------------------------------------------------------/
